03 03 03 03 03 03 03 03 03 03 03 03 03 03 03 03 03 03 03 03 03 03 03 03 03 03 03 03 03 03
03 09 09 09 09 09 09 09 09 09 09 09 09 09 09 03 09 09 09 09 09 09 09 09 09 09 09 09 09 09
03 09 09 09 09 09 09 09 09 09 09 09 09 09 09 03 09 09 09 09 09 09 09 09 09 09 09 09 09 09
03 09 09 09 09 09 09 09 09 09 09 09 09 09 09 03 09 09 09 09 09 09 09 09 09 09 09 09 09 09
03 09 09 09 09 09 09 09 09 09 09 09 09 09 09 03 09 09 09 09 09 09 09 09 09 09 09 09 09 09
03 09 09 09 09 09 09 09 09 09 09 09 09 09 09 03 09 09 09 09 09 09 09 09 09 09 09 09 09 09
03 09 09 09 09 09 09 09 09 09 09 09 09 09 09 03 09 09 09 09 09 09 09 09 09 09 09 09 09 09
03 09 09 09 09 09 09 09 09 09 09 09 09 09 09 03 09 09 09 09 09 09 09 09 09 09 09 09 09 09
03 09 09 09 09 09 09 09 09 09 09 09 09 09 09 03 09 09 09 09 09 09 09 09 09 09 09 09 09 09
03 09 09 09 09 09 09 09 09 09 09 09 09 09 09 03 09 09 09 09 09 09 09 09 09 09 09 09 09 09
03 09 09 09 09 09 09 09 09 09 09 09 09 09 09 03 09 09 09 09 09 09 09 09 09 09 09 09 09 09
03 09 09 09 09 09 09 09 09 09 09 09 09 09 09 03 09 09 09 09 09 09 09 09 09 09 09 09 09 09
03 09 09 09 09 09 09 09 09 09 09 09 09 09 09 03 09 09 09 09 09 09 09 09 09 09 09 09 09 09
03 09 09 09 09 09 09 09 09 09 09 09 09 09 09 03 09 09 09 09 09 09 09 09 09 09 09 09 09 09
03 09 09 09 09 09 09 09 09 09 09 09 09 09 09 03 09 09 09 09 09 09 09 09 09 09 09 09 09 09
03 09 09 09 09 09 09 09 09 09 09 09 09 09 09 03 09 09 09 09 09 09 09 09 09 09 09 09 09 09
03 09 09 09 09 09 09 09 09 09 09 09 09 09 09 03 09 09 09 09 09 09 09 09 09 09 09 09 09 09
03 09 09 09 09 09 09 09 09 09 09 09 09 09 09 03 09 09 09 09 09 09 09 09 09 09 09 09 09 09
03 09 09 09 09 09 09 09 09 09 09 09 09 09 09 03 09 09 09 09 09 09 09 09 09 09 09 09 09 09
03 09 09 09 09 09 09 09 09 09 09 09 09 09 09 03 09 09 09 09 09 09 09 09 09 09 09 09 09 09
03 09 09 09 09 09 09 09 09 09 09 09 09 09 09 03 09 09 09 09 09 09 09 09 09 09 09 09 09 09
03 09 09 09 09 09 09 09 09 09 09 09 09 09 09 03 09 09 09 09 09 09 09 09 09 09 09 09 09 09
03 09 09 09 09 09 09 09 09 09 09 09 09 09 09 03 09 09 09 09 09 09 09 09 09 09 09 09 09 09
03 09 09 09 09 09 09 09 09 09 09 09 09 09 09 03 09 09 09 09 09 09 09 09 09 09 09 09 09 09
03 03 03 03 03 03 03 03 03 03 03 03 03 03 03 03 09 09 09 09 09 09 09 09 09 09 09 09 09 09
03 03 03 03 03 03 03 03 03 03 03 03 03 03 03 03 03 03 03 03 03 03 03 03 03 03 03 03 03 03
03 09 09 09 09 09 09 09 09 09 09 09 09 09 09 03 09 09 09 09 09 09 09 09 09 09 09 09 09 09
03 09 09 09 09 09 09 09 09 09 09 09 09 09 09 03 09 09 09 09 09 09 09 09 09 09 09 09 09 09
03 09 09 09 09 09 09 09 09 09 09 09 09 09 09 03 09 09 09 09 09 09 09 09 09 09 09 09 09 09
03 09 09 09 09 09 09 09 09 09 09 09 09 09 09 03 09 09 09 09 09 09 09 09 09 09 09 09 09 09
03 09 09 09 09 09 09 09 09 09 09 09 09 09 09 03 09 09 09 09 09 09 09 09 09 09 09 09 09 09